00000000000000000000000000000000000000000000000000
00000000000000000000000000000000000000000000000000
00000000000000000000000000000000000000000000000000
11111111001111111111111111111111111111111001111111
00000000000000000000000000000000000000000000000000
00000000000000000000000000000000000000000000000000
00000000000000000000000000000000000000000000000000
00000000000000000000000000000000000000000000000000
00000000000000000000011111110000000000000000000000
11000111110000000000011111110000000000011111100011
11000000010000000000011111110000000000010111100011
11000000010000000000011111110000000000010111100011
11000000010000000000011111110000000000010111100011
11000000010000000000011111110000000000010111100011
11000000010000000000011111110000000000010111100011
11000111010000000000011111110000000000010111100011
11000101010000000000011111110000000000010000000011
11000000000000000000011111110000000000000000000011
11000000000000000000011111110000000000000000000011
11000000000000000000011111110000000000000000000011
11111111010000000000000000000000000000010111100011
11111111010000000000000000000000000000010111100011
11111111010000000000000000000000000000010111100011
11111111011100000111111111111111000001110111100011
11111111111100000111111101111111000001110111100011
11100000000000000000000000000000000000010111100011
11100000000000000000000000000000000000011111000011
11100000000000000000000000000000000000000001000011
11100000000000000000000000000000000000000001000011
11100000000000000000000000000000000000000001000011
11100000000000000000011111110000000000000001000011
11100000000000000000011111110000000000000001000011
11100000000000000000011111110000000000000001000011
11100000000000000000011111110000000000000001000011
11100000000000000000011111110000000000000001000011
11100000000000000000011111110000000000001111000011
11100000000000000000011111110000000000001000000011
11111111110000000000011111110000000000001111100011
11111111010000000000011111110000000000001111100011
11111111010000000000011111110000000000001111100011
11111111010000000000011111110000000000001111100011
11111111010000000000011111110000000000001111100011
11111111010000000000011111110000000000001111100011
11111111010000000000011111110000000000001111100011
00000000010000000000011111110000000000001111100000
11111111110000000000000000000000000000001111100011
00000000000000000000000000000000000000000000000000
00000000000000000000000000000000000000000000000000
00000000000000000000000000000000000000000000000000
00000000000000000000000000000000000000000000000000